article(entr),page,user,portal,template,category,total
!Kung people,37,95,0,1,0,133
African music,266,13,6,1,1,287
Acid,488,4,0,1,4,497
Africa Day,141,4,0,2,0,147
Animal husbandry in South Africa,2,3,0,0,0,5
Aloe vera,122,51,0,0,0,173
Animal-powered transport,179,12,4,2,1,198
Alcohol dependence,172,69,0,2,2,245
AIDS orphan,191,17,1,1,1,211
Bill of Rights (South Africa),18,0,0,0,0,18
Alcoholism,497,1,0,0,0,498
Alcohol abuse,367,31,6,2,1,407
Base (chemistry),462,17,2,1,3,485
Boiling,353,41,5,4,0,403
Bias,380,41,0,1,1,423
Apartheid,492,3,0,0,0,495
Bicycle,466,14,0,1,2,483
Borehole,279,22,6,1,2,310
Atom,494,4,0,0,0,498
Children%27s Act (South Africa),1,0,0,0,0,1
Automobile,493,3,0,0,0,496
Agriculture in South Africa,159,14,0,2,0,175
Child abuse,491,1,0,0,1,493
Castle of Good Hope,97,6,4,2,0,109
Cell (biology),495,3,0,0,0,498
Bullying,482,2,1,1,0,486
Ceramic,496,2,0,0,1,499
Animal husbandry,474,10,3,0,0,487
Bird nest,489,2,2,1,0,494
Biome,430,7,3,1,16,457
Circuit diagram,114,39,4,0,1,158
Aloe,303,36,6,25,1,371
Control variable,12,5,0,0,0,17
Convenience food,133,10,2,2,1,148
Clay,498,1,0,0,0,499
Coal,500,0,0,0,0,500
Climate,500,0,0,0,0,500
Discrimination,487,4,0,0,0,491
Decanting,6,1,0,0,0,7
Domestic violence in South Africa,69,8,0,1,0,78
Cradle of Humankind,96,14,1,2,0,113
Dependent and independent variables,179,79,2,3,0,263
Domestic violence,489,4,0,0,0,493
Coal in South Africa,88,10,3,2,0,103
Cooking,423,59,1,0,2,485
Design,464,21,1,0,4,490
Duration (music),81,16,0,1,0,98
Energy in South Africa,93,9,0,2,2,106
Frances Baard,10,2,1,0,0,13
Food groups,14,8,2,0,0,24
Electrical conductor,362,17,16,2,1,398
Freedom Day (South Africa),32,4,1,1,0,38
Food pyramid (nutrition),15,6,0,0,0,21
Electricity generation,476,5,6,0,0,487
Health care in South Africa,93,5,0,2,0,100
Home safety,1,2,0,0,0,3
Gender stereotypes,46,11,4,1,0,62
Hand washing,214,39,3,3,0,259
Gangster,393,41,2,0,0,436
Hottentot Venus,9,3,0,0,0,12
Electrical network,350,50,4,3,1,408
Liquid fuel,61,3,4,0,0,68
Khoikhoi mythology,85,2,2,1,0,90
HIV/AIDS,488,1,2,1,1,493
Food,498,1,0,0,0,499
National anthem of South Africa,106,6,0,2,0,114
National symbols of South Africa,99,9,0,2,0,110
Mapungubwe National Park,31,3,0,1,0,35
Insulator (electricity),261,86,4,3,0,354
Human swimming,494,2,3,0,1,500
List of South Africans,117,14,0,1,0,132
Fire safety,316,25,0,1,0,342
Petrol-paraffin engine,11,1,0,0,0,12
Road map,28,5,2,1,1,37
Fiber,471,6,4,0,0,481
Mpumalanga,474,4,1,10,3,492
Noise pollution,378,13,8,1,1,401
Health,458,14,3,0,5,480
Reconciliation Day,1,0,0,0,0,1
Khoikhoi,298,30,8,5,1,342
Right to food,115,15,2,2,0,134
Glass,492,5,0,0,0,497
Human nutrition,191,43,5,2,0,241
Rail transport in South Africa,441,8,0,1,1,451
Heritage Day (South Africa),27,3,1,1,0,32
Rail transport,499,0,0,0,0,499
Herero and Namaqua Genocide,220,21,8,8,0,257
Gauteng,496,0,3,0,0,499
Latitude,489,5,0,0,0,494
Hydraulics,477,8,0,1,1,487
Paper,493,5,0,0,0,498
Malaria,497,2,0,0,0,499
Reproduction,454,11,3,0,1,469
Drakensberg,374,22,3,2,1,402
Map,416,69,4,0,3,492
Outline of domestic violence,158,18,5,3,0,184
San healing practices,7,1,3,0,0,11
Outer space,472,6,0,0,0,478
Rock (geology),490,2,0,0,1,493
History of writing,361,23,16,5,1,406
Pneumatics,290,33,4,2,0,329
Pitch (music),494,1,0,1,0,496
Gana and Gwi people,9,1,0,0,0,10
Food vs. fuel,266,61,2,3,4,336
Griqua people,246,7,2,6,0,261
Farm,483,3,3,0,1,490
San religion,96,7,4,3,3,113
Mandela Day,95,4,0,1,0,100
Later Stone Age,51,10,0,2,0,63
Mapungubwe,31,4,0,0,0,35
Human Rights Day,174,17,14,3,0,208
San languages,29,1,0,1,1,32
Mapungubwe Museum,36,0,0,1,12,49
Sexism,473,6,1,0,1,481
Sieving,14,4,0,0,0,18
Free State (province),364,7,0,9,11,391
San rock art,11,1,0,0,0,12
Mining industry of South Africa,138,7,2,2,0,149
San people,242,15,2,3,0,262
Fair trade,458,10,2,2,3,475
National Women's Day,41,2,11,1,0,55
Music of South Africa,318,36,0,7,7,368
Oliver Tambo,268,11,0,4,1,284
People Against Gangsterism and Drugs,244,10,0,1,3,258
Nest,352,40,30,7,0,429
Nelson Mandela,498,2,0,0,0,500
Republic of South Africa,281,19,7,2,2,311
Longitude,470,11,0,2,0,483
Ecosystem,493,4,0,0,0,497
Pollution,479,14,1,0,1,495
Sound,482,5,0,1,5,493
Soil,494,2,0,0,0,496
South African locomotive history,348,2,0,1,0,351
Water filter,84,15,1,0,1,101
Water supply and sanitation in South Africa,41,12,0,0,2,55
Tap (valve),112,12,2,0,0,126
Steve Biko,431,8,8,5,0,452
Two foot gauge railways in South Africa,39,0,0,0,0,39
Winnie Madikizela-Mandela,389,31,2,5,0,427
Youth culture,128,18,3,0,0,149
Standard Model,402,33,8,4,1,448
Vibration,412,20,4,2,1,439
Water well,494,0,0,1,0,495
Stereotype,473,10,0,1,2,486
Water privatization in South Africa,2,5,0,0,0,7
Transport in South Africa,164,5,0,2,2,173
Wildlife management,320,18,13,4,1,356
Water pollution,458,3,8,0,3,472
Settling,55,22,0,0,0,77
Wax,480,7,3,0,3,493
Mahatma Gandhi,491,5,0,0,0,496
Wood,498,2,0,0,0,500
Wetlands,487,5,3,0,2,497
Scientific method,476,10,0,0,0,486
Sand,490,3,0,1,0,494
Scale (map),117,21,5,9,0,152
South African cuisine,484,7,2,3,0,496
HIV,496,1,0,0,0,497
Trade,494,4,0,1,0,499
Walter Sisulu,238,11,1,3,1,254
Transport,485,6,0,0,0,491
Wool,500,0,0,0,0,500
Wildlife conservation,488,0,2,0,1,491
Textile,497,1,0,0,0,498
Western Cape,489,2,2,1,1,495
Children%27s Day,195,17,44,2,0,258
Economy of South Africa,411,7,5,7,1,431
Flag of South Africa,301,47,5,11,0,364
Politics of South Africa,437,8,9,16,5,475
Food security,423,16,21,2,0,462
History of South Africa,331,25,7,7,1,371